"glide","house","aside","fried","igloo","photo","cried","slide","snake","tiger","fight","right","night","sight","lives",
"knife","mouse","truck","about","alert","argue","beach",
Above	Alike	Arise	Began
Abuse	Alive	Array	Begin
Actor	Allow	Aside	Begun
Acute	Alone	Asset	Being
Admit	Along	Audio	Below
Adopt	Alter	Audit	Bench
Adult	Among	Avoid	Billy
After	Anger	Award	Birth
Again	Angle	Aware	Black
Agent	Angry	Badly	Blame
Agree	Apart	Baker	Blind
Ahead	Apple	Bases	Block
Alarm	Apply	Basic	Blood
Album	Arena	Basis	Board
Boost	Buyer	China	Cover
Booth	Cable	Chose	Craft
Bound	Calif	Civil	Crash
Brain	Carry	Claim	Cream
Brand	Catch	Class	Crime
Bread	Cause	Clean	Cross
Break	Chain	Clear	Crowd
Breed	Chair	Click	Crown
Brief	Chart	Clock	Curve
Bring	Chase	Close	Cycle
Broad	Cheap	Coach	Daily
Broke	Check	Coast	Dance
Brown	Chest	Could	Dated
Build	Chief	Count	Dealt
Built	Child	Court	Death
Debut	Entry	Forth	Group
Delay	Equal	Forty	Grown
Depth	Error	Forum	Guard
Doing	Event	Found	Guess
Doubt	Every	Frame	Guest
Dozen	Exact	Frank	Guide
Draft	Exist	Fraud	Happy
Drama	Extra	Fresh	Harry
Drawn	Faith	Front	Heart
Dream	False	Fruit	Heavy
Dress	Fault	Fully	Hence
Drill	Fibre	Funny	Night
Drink	Field	Giant	Horse
Drive	Fifth	Given	Hotel
Drove	Fifty	Glass	House
Dying	Fight	Globe	Human
Eager	Final	Going	Ideal
Early	First	Grace	Image
Earth	Fixed	Grade	Index
Eight	Flash	Grand	Inner
Elite	Fleet	Grant	Input
Empty	Floor	Grass	Issue
Enemy	Fluid	Great	Irony
Enjoy	Focus	Green	Juice
Enter	Force	Gross	Joint
Judge	Metal	Media	Newly
Known	Local	Might	Noise
Label	Logic	Minor	North
Large	Loose	Minus	Noted
Laser	Lower	Mixed	Novel
Later	Lucky	Model	Nurse
Laugh	Lunch	Money	Occur
Layer	Lying	Month	Ocean
Learn	Magic	Moral	Offer
Lease	Major	Motor	Often
Least	Maker	Mount	Order
Leave	March	Mouse	Other
Legal	Music	Mouth	Ought
Level	Match	Movie	Paint
Light	Mayor	Needs	Paper
Limit	Meant	Never	Party
Peace	Power	Radio	Round
Panel	Press	Raise	Route
Phase	Price	Range	Royal
Phone	Pride	Rapid	Rural
Photo	Prime	Ratio	Scale
Piece	Print	Reach	Scene
Pilot	Prior	Ready	Scope
Pitch	Prize	Refer	Score
Place	Proof	Right	Sense
Plain	Proud	Rival	Serve
Plane	Prove	River	Seven
Plant	Queen	Quick	Shall
Plate	Sixth	Stand	Shape
Point	Quiet	Roman	Share
Pound	Quite	Rough	Sharp
Sheet	Spare	Style	Times
Shelf	Speak	Sugar	Tired
Shell	Speed	Suite	Title
Shift	Spend	Super	Today
Shirt	Spent	Sweet	Topic
Shock	Split	Table	Total
Shoot	Spoke	Taken	Touch
Short	Sport	Taste	Tough
Shown	Staff	Taxes	Tower
Sight	Stage	Teach	Track
Since	Stake	Teeth	Trade
Sixty	Start	Texas	Treat
Sized	State	Thank	Trend
Skill	Steam	Theft	Trial
Sleep	Steel	Their	Tried
Slide	Stick	Theme	Tries
Small	Still	There	Truck
Smart	Stock	These	Truly
Smile	Stone	Thick	Trust
Smith	Stood	Thing	Truth
Smoke	Store	Think	Twice
Solid	Storm	Third	Under
Solve	Story	Those	Undue
Sorry	Strip	Three	Union
Sound	Stuck	Threw	Unity
South	Study	Throw	Until
Space	Stuff	Tight	Upper
Upset	Whole	Waste	Wound
Urban	Whose	Watch	Write
Usage	Woman	Water	Wrong
Usual	Train	Wheel	Wrote
Valid	World	Where	Yield
Value	Worry	Which	Young
Video	Worse	While	Youth
Virus	Worst	White	Worth
Visit	Would	Vital	Voice
bleat	skate	crate	sweat
cleat	cheat	freak	wheat
exact	treat	sheet   great
vials	viper	vista   villa	
viral	vibes   visit	viola	
vital   vivid	vinyl	video					
Trait	Trail	Trial	Trick	virus
Thick	Trend	Twist	Tribe	Truck
Tough	Troop	Tight	Truth	Trust
Thumb	Thump	Thank	Tempt   Tiger
These	Thigh	Twice	Touch	Treat
Tooth	Throw	Three	Tally	Teach
Tempo	Taboo	Tears	Trunk	Those
Tuner	Timid	Tummy	Twist	Tweet
Tweak	Truly	Toast	Toxic   Tabla
Toxin	Torch	Think	Tease	Thief
Thorn	Theft	Throb	Thing	Trade
Theme	Title	Taunt	Tasty	Today
smoke	setup	shell	sixty	scalp
share	shirt	sleek	shark	sleep
shoes	smoky	sense	shelf	sixth
sally	sassy	salon	salsa	satin
saint	salty	sauce	sadly	saree
saute	salad	saver	saggy	sandy
savoy	savvy	scary	scoop	scoot
screw	scuff	scald	scale	scrim
scope	scrip	scalp	score	scaly
scorn	scamp	scent	scant	scrum
scout	scuba	scowl	scape	scion
scrab	scare	scarf	scold	scoff
scone	scarp	scute	sculk	sewer
sepal	serum	sepia	serve	seedy
setup	seven	sedan	sever	serge
seize	sense	shore	shade	sheaf
shirk	shaft	shear	shirt	short
shake	shout	shaky	sheep	sheer
sheet	showy	shelf	shell	shred
shoal	shrew	shock	shrub	shrug
shale	sharp	shift	shave	shine
shoot	shawl	shiny	sieve	siege
sight	sinus	silky	sixer	silly
sixth	siren	sixty	skrik	skirt
skate	skein	skill	skull	slack
slink	sleep	slang	slice	slick
slant	slide	sloom	slate	slime
slope	slurp	slush	sling	sloth
smell	small	smoke	smout	smile
smart	smoky	smirk	snack	snail
snake	sneap	snoot	snipe	snore
snout	snowy	solar	soapy	sober
sound	soppy	solid	south	softy
solve	space	spawl	spawn	spade
spewy	speak	spice	spicy	spear
spoil	spoof	speck	speed	spike
spoon	spare	spark	spell	spill
spilt	sport	spasm	spend	spine
spout	spiny	spurn	spray	squad
squat	squid	steel	stack	steem
staff	steep	stage	steer	steno
strap	straw	stock	stray	stain
stell	stair	stent	stake	stoic
stalk	stall	stern	stamp	stand
stomp	stove	stone	stick	stuck
stare	stiff	study	stilt	stool
start	style	state	stoop	stash
stead	steak	steal	store	sting
steam	stork	stink	stipe	storm
stunt	story	steed	stout	suave
sugar	suite	surge	sunny	super
sulky	sushi	sweet	swirl	swarm
swell	swamp	swear	swing	sweep